
{
    "width": 7,
    "height": 7,
    "map": [
    "#######",
    "#.....#",
    "#..B..#",
    "#..P..#",
    "#..T..#",
    "#.....#",
    "#######"
    ]
}
