{
    "width": 7,
    "height": 7,
    "map": [
        "#######",
        "#...T.#",
        "#.##..#",
        "#..PB.#",
        "#.##..#",
        "#.....#",
        "#######"
    ]
}