{
    "width": 9,
    "height": 7,
    "map": [
        "#########",
        "#...T...#",
        "#.##....#",
        "#..PB...#",
        "#.##....#",
        "#.B..T..#",
        "#########"
    ]
}